WWWWWWWWWWWWWWW
SFFFFWFFFFWFFFW
WFWWFWWWWFWFWFW
WFWFFWFFFFWFWFW
WFWWWWFWFWWFWWW
WFFFFFFWFWFFFFW
WFWFWWWWFWFWWWW
WFWWWFFFFWFWFFW
WFWFFFWFWWFWWFW
WFWFWWWFWFFFWFW
WWWFWFFFWFWFWFW
WFFFWWWFWFWFFFW
WFWWWFFFWFWWWFW
WFFFFFWFFFFFWFX
WWWWWWWWWWWWWWW
