WWWWWWWWWWWWWWW
SPPPPWPPPPWPPPW
WPWWPWWWWPWPWPW
WPWPPWPPPPWPWPW
WPWWWWPWPWWPWWW
WPPPPPPWPWPPPPW
WPWPWWWWPWPWWWW
WPWWWPPPPWPWPPW
WPWPPPWPWWPWWPW
WPWPWWWPWPPPWPW
WWWPWPPPWPWPWPW
WPPPWWWWWPWPPPW
WPWWWPPPWPWWWPW
WPPPPPWPPPPPWPX
WWWWWWWWWWWWWWW
